R Kelly  Celine Dion: Im Your Angel 
Deborah Cox: Nobodys Supposed To Be Here 
Divine: Lately 
Britney Spears: Baby One More Time 
 Degrees: Because Of You 
Shania Twain: From This Moment On 
Lauryn Hill: Doo Wop That Thing 
Total Featuring Missy Elliott: Trippin 
Brandy: Have You Ever 
Faith Evans: Love Like This 
Spice Girls: Goodbye 
Shawn Mullins: Lullaby 
EagleEye Cherry: Save Tonight 
Faith Hill: This Kiss 
Jewel: Hands 
Goo Goo Dolls: Slide 
Third Eye Blind: Jumper 
 Featuring Mase: Love Me 
Mark Chesnutt: I Dont Want To Miss A Thing 
JayZ Featuring Amil Of Major Coinz  Ja: Can I Get A 
Mo Thugs Family Featuring Bone ThugsNHarmony: Ghetto Cowboy 
Goo Goo Dolls: Iris 
Monica: The First Night 
BLACKstreet  Mya Featuring Mase  Blinky Blink: Take Me There 
Sarah McLachlan: Angel 
Edwin McCain: Ill Be 
Sheryl Crow: My Favorite Mistake 
Dru Hill Featuring Redman: How Deep Is Your Love 
Will Smith: Miami 
Ice Cube Featuring Mr Short Khop: Pushin Weight 
Dru Hill: These Are The Times 
Alanis Morissette: Thank U 
Monifah: Touch It 
Eve : Inside Out 
NSYNC: God Must Have Spent A Little More Time On You 
Monica: Angel Of Mine 
Barenaked Ladies: One Week 
JAYZ: Hard Knock Life Ghetto Anthem 
Next: Too Close 
Brian McKnight Featuring Tone  Kobe Bryant: Hold Me 
Aaron Hall: All The Places I Will Kiss You 
Clay Walker: Youre Beginning To Get To Me 
Madonna: The Power Of GoodBye 
Pac: Changes 
BlackHawk: There You Have It 
Collin Raye: Someone You Used To Know 
Aaliyah: Are You That Somebody 
Martina McBride: Wrong Again 
Terri Clark: Youre Easy On The Eyes 
New Radicals: You Get What You Give 
Alan Jackson: Right On The Money 
Lenny Kravitz: Fly Away 
Aaron Tippin: For You I Will 
Sara Evans: No Place That Far 
Randy Travis: Spirit Of A Boy Wisdom Of A Man 
Keith Sweat Featuring Snoop Dogg: Come And Get With Me 
The Offspring: Pretty Fly For A White Guy 
Cher: Believe 
OutKast: Rosa Parks 
Brooks  Dunn: Husbands And Wives 
Tim McGraw: For A Little While 
Faith Hill: Let Me Let Go 
Jo Dee Messina: Stand Beside Me 
Whitney Houston  Mariah Carey: When You Believe 
John Michael Montgomery: Hold On To Me 
Barenaked Ladies: Its All Been Done 
U: Sweetest Thing 
The Wilkinsons: Fly The Angel Song 
Voices Of Theory: Wherever You Go 
R Kelly: When A Womans Fed Up 
Reba: Wrong Night 
Diamond Rio: Unbelievable 
TQ: Westside 
Five: Its The Things You Do 
Everlast: What Its Like 
matchbox : Back  Good 
Whitney Houston Feat Faith Evans  Kelly Price: Heartbreak Hotel 
Dixie Chicks: Wide Open Spaces 
Shaggy Featuring Janet: Luv Me Luv Me 
Adam Sandler: The Chanukah Song 
Brandy: Angel In Disguise 
Aerosmith: I Dont Want To Miss A Thing 
Everclear: Father Of Mine 
Cake: Never There 
Ty Herndon: It Must Be Love 
Case  Joe: Faded Pictures 
R Kelly Featuring Keith Murray: Home Alone 
Everything: Hooch 
George Strait: We Really Shouldnt Be Doing This 
Fastball: Fire Escape 
Xscape: My Little Secret 
Mark Wills: Dont Laugh At Me 
Hole: Celebrity Skin 
Willie Max Featuring Raphael Saadiq: Cant Get Enough 
Shae Jones: Talk Show Shhh 
Alabama: How Do You Fall In Love 
Deryl Dodd: A Bitter End 
Lee Ann Womack: A Little Past Little Rock 
Kirk Franklin Featuring Mary J Blige Bono R Kelly Crystal Lewis  The Family: Lean On Me 
Garth Brooks: Its Your Song 
